-21
24
-15
32
0000000000000000000000000000000000000000000000
0000000000111111111111111100000000000000000000
0000000000100000000000000100000000000000000000
0000000000100010000000010100000000000000000000
0000000000100000000000000100000000000000000000
0000000000100000001000000100000000000000000000
0000000000100000000001000111111111100000000000
0000000000100000000000000000000000100000000000
0000000000101000000000000000000100100000000000
0000000000100000000000000000000000100000000000
0000000000100000000000000000010000100000000000
0000000000100000000000000000000000100000000000
0000000000100000110000000001000010100000000000
0000011111100000110100000000000000111100000000
0000010000011111111111111001111111000100000000
0000010100010001001000001001001100000100000000
0000010001000000000000001001000000000100000000
0000010000000000000000001001000001000100000000
0000010100010000000000001001000000000100000000
0000010000000000000010001001000000000111111000
0000010000000000000000001001000000000100001000
0000010000000011110011111001111110000111101000
0000010000000011110011111001111110000001001000
0000010000001010010001010000000010000001001000
0000010011111100000000000000000010000001001000
0000010011111100000000000000000100001001001000
0000010010000000000000000000000100001000001000
0000010010000000000000000000001000001000001000
0000010010000000000000000000001001001000001000
0000010010000000000000000000000001001000001000
0000010011000000000000000000000001001000101000
0000010011100000000000000000000001101111111000
0000010011100000000000000000000001001100000000
0000010011111111111111111100000001001100000000
0001110000000000001000100100000001001111100000
0001001000000000000000000100000001011000100000
0001011100111111111111111100000011111010100000
0001001100111111111111111100000001111010100000
0001001000001100110000000000000000100000100000
0001000000000000000000000000000000000000100000
0001010000000000000000000000000000000010100000
0001111111111111111110000000000011111111100000
0000000000000000000010000001000010000000000000
0000000000000000000010000100001010000000000000
0000000000000000000011111111111110000000000000
0000000000000000000000000000000000000000000000
0000000000000000000000000000000000000000000000
0000000000000000000000000000000000000000000000
